##########
#........#
#........#
#...#....#
#...#....#
#...#....#
#...#..X.#
##########
